Name	title	coding
t3_j9346j	/r/Conservative Official Political Discord	Non-candidate
t3_jybw7n	Texas Passes Law Banning Californians From Voting After They Move There	Non-candidate
t3_jybw1v	Don’t ‘Californicate’ The Rest Of America	Non-candidate
t3_jya6cm	Hungarian Prime Minister: 'Soros One of the Most Corrupt People in World'	Non-candidate
t3_jyb6wn	Exiled Tibetan leader Lobsang Sangay visits White House, irking China	Non-candidate
t3_jy4b5e	Ben Carson says he's 'out of the woods' after being 'extremely sick' with COVID-19	Non-candidate
t3_jyc9qd	CA-21 Republican David Valadao defeats Democrat Incumbent TJ Cox -- Reclaims another District stolen by ballot harvesting in 2018	Non-candidate
t3_jygcv2	Joseph Stalin To Receive International Emmy For His Outstanding Hunger Relief Efforts	Non-candidate
t3_jybxek	Gov. Cuomo wins Emmy for Best Portrayal of A Mass Murderer. “People around the world tuned in to find out what was going on and who Cuomo was going to kill next. It was really quite riveting”	Non-candidate
t3_jyex3l	The Dems and Liberal Media Have Raised Issues with Dominion, Smartmatic, and ES&amp;S for 20 Years. The Left and media has Known About Chavez's Ties to Smartmatic since 2006. Here's the Stories That They Can't Unwrite	Non-candidate
t3_jyc4mm	In new twist, Georgia governor urges audit of ballot envelop signatures to look for fraud	Non-candidate
t3_jyfczv	Sacramento Sheriff on Not Enforcing COVID Curfew: Making Cops 'Instruments' of 'Oppression' Damages Community Relations	Non-candidate
t3_jyf6s6	Sidney Powell: Whistleblowers 'May Need Witness Protection' After Their Allegations Are Brought to Light	Non-candidate
t3_jyazd0	The student loan crisis solved. Simple solutions are the best.	Non-candidate
t3_jy8o93	Our hypocritical leaders refuse to obey their own COVID-19 rules. Actually, all the COVID rules are for us, not them. And the message that comes through loud and clear: Wink, wink — COVID’s not really that big a deal.	Non-candidate
t3_jydeaa	Green Card Holder in Nevada Received Mail-In Ballot	Non-candidate
t3_jydelh	Giuliani Alleges Dominion Director's Ties to Antifa	Non-candidate
t3_jyfm9t	Finally America is realizing that Andrew Cuomo is a putz	Non-candidate
t3_jyhqpn	"Waffle House’s Stand Against Lockdowns Is Exactly What America Needs—Almost | ""None of the people who make the decisions to shut down businesses and impact people's livelihoods ever have their own livelihood impacted,"" the Waffle House CEO recently told Business Insider."	Non-candidate
t3_jy8rml	81-year-old former Marine uses his grandfather's Irish shillelagh to beat down burglars and drive them away	Non-candidate
t3_jyaxu6	Scalise: GOP Gave Moderate Dems Chance to Vote with Us for the Last 2 Years; They Voted with Pelosi, AOC 90% of the Time	Non-candidate
t3_jydomn	Gut check.	Non-candidate
t3_jya8e5	Carlson: 'Great News' if Powell Proves Tech Companies Switched Millions of Votes -- Uncovered 'Greatest Crime in the History of This Country'	Non-candidate
t3_jyezy9	Sens. Warren, Klobuchar Sent Letter Warning About Dominion, Other Election Tech in 2019	Non-candidate
t3_jyfgsz	"Jordan Sekulow: Pending Georgia Lawsuit 'Shocking' -- To those saying ""put up or shut up, it's coming this week."""	Non-candidate
t3_jxzwnd	Every County Sheriff in L.A. Region Declines to Enforce Gavin Newsom's Coronavirus Curfew	Non-candidate
t3_jyadln	Did You Know: Majority Of State Capitols Will Have Nativity Scene Displays In 2020; More To Come	Non-candidate
t3_jybjtt	If lockdowns work, why are they emptying the prisons?	Non-candidate
t3_jydz3d	Sen. Tom Cotton: It's the 400th anniversary of the Pilgrims' arrival. Why haven't we heard more about it?	Non-candidate
t3_jxvfcc	'We Must Cancel Thanksgiving,' Says CDC Scientist Who Looks Suspiciously Like A Turkey In A Lab Coat	Non-candidate
t3_jy46nb	Liberals lash out at former child star Ricky Schroder after he helps bail Kyle Rittenhouse out of jail	Non-candidate
t3_jy0jq8	"Pro-Life Students Arrested For ""Black Preborn Lives Matter"" Chalking... Now They're Suing The City"	Non-candidate
t3_jygbnc	Michigan, National Republicans Want State Certification Delayed	Non-candidate
t3_jybm40	Appeals court upholds 'reason bans,' denying abortions over Down Syndrome, gender or race	Non-candidate
t3_jygcko	Tibetan political leader makes visit to White House for first time in six decades	Non-candidate
t3_jy4ptr	Georgia Governor Calls for Audit of Signatures on Ballot Envelopes	Non-candidate
t3_jye9se	Smartmatic email addresses show up in hacking groups for malware (makers of Dominion voting software) The Hackingteam Archives	Non-candidate
t3_jy2qnh	Kyle Rittenhouse Says He Purchased AR-15 with COVID Stimulus Check	Non-candidate
t3_jy13sv	Pennsylvania house orders election audit	Non-candidate
t3_jy2cli	Close to 100,000 Ballots in Pennsylvania Flagged by Math Professor in Sworn Affidavit	Non-candidate
t3_jy4wx9	2020 Recount Ordered In Wisconsin	Non-candidate
t3_jyh4ma	‘I Had To Protect Myself’: Rittenhouse Speaks Out Before Jail Release; New Details Emerge About Fatally Shot Rioter	Non-candidate
t3_jy6b5w	Congresswoman-elect starting 'Freedom Force' as counterweight to Dems' 'Squad'	Non-candidate
t3_jxtfum	Thanksgiving is November 26. Are you ready?	Non-candidate
t3_jygjwb	Dems launch personal attacks against Wayne County GOP canvassers | One America News Network	Non-candidate
t3_jyb1gi	Judge tosses last election lawsuit in Arizona	Non-candidate
t3_jydeux	Loeffler Calls for Bipartisan Group to Examine Georgia Mail-in Ballots	Non-candidate
t3_jyb2fr	IRONY ALERT: Newsom’s Restrictions Include Swanky Restaurant that Hosted His Infamous Dinner Party | Sean Hannity	Non-candidate
t3_jy2yn9	Georgia Voting Meltdown in June Involved Dominion Voting machines	Non-candidate
t3_jy1vb6	Satire: Democrats Push To Keep Schools Closed So Kids Will Be Dumb Enough To Accept Socialism	Non-candidate
t3_jya5xb	Michigan GOP: We Are Putting the Secretary of State on Notice	Non-candidate
t3_jydaz1	If the Orange Man really wanted to be as BAD as you think he is.	Non-candidate
t3_jy2yor	Multiple California Sheriffs Say They Will Not Enforce Gov. Newsom's New COVID Restrictions	Non-candidate
t3_jxx5ob	Republican Ex-Rep. Tenney Wins Back Her Seat by 106 Votes in Nail-Biting NY-22 Race	Non-candidate
t3_jyd2bv	A rude awakening coming to Europe	Non-candidate
t3_jyi8r3	CA-25 Republican Rep. Mike Garcia Claims Victory; Democrat Christy Smith Cries Foul	Non-candidate
t3_jyh39n	Sheriffs not enforcing Newsom's coronavirus curfew, won't 'make criminals' of law-abiding citizens	Non-candidate
t3_jxs99k	Black Female Police Chief in Virginia Fired After Aggressively Investigating and Prosecuting BLM Mob Violence	Non-candidate
t3_jydirx	An Incredibly Relevant Winston Churchill Quote about Enemies	Non-candidate
t3_jxzytc	Dominion Voting Systems Backs Out of Hearing, 'Lawyers Up,' PA GOP Furious, 'Why Are They Hiding?'	Non-candidate
t3_jyfsno	Mich. back in play as Wayne County GOP canvassers rescind certifications | One America News Network	Non-candidate
t3_jxrjrm	Dominion systems refuses to show up to Pennsylvania hearings	Non-candidate
t3_jy4qhv	Data Scientist Flags Around 90,000 Votes in Pennsylvania	Non-candidate
t3_jyhv8l	Drug overdose killed him, not my knee on his neck – Officer in George Floyd’s death	Non-candidate
t3_jy0gpq	Racist Left-Wing Video Violates Facebook’s 'Hate Speech' Guidelines, Remains Uncensored	Non-candidate
t3_jydl7u	7 Ways the 2005 Carter-Baker Report Could Have Averted Problems With 2020 Election	Non-candidate
t3_jxxqtz	Kyle Rittenhouse released from custody on $2 million cash bond	Non-candidate
t3_jyheq5	Jonathan Turley weighs in on Michigan AG's threats against Republicans who oppose certification	Non-candidate
t3_jyfian	Dutch Doctors Can Now Drug Dementia Patients Before Killing Them to Prevent Resistance	Non-candidate
t3_jydd2e	White House: Some states have ‘Orwellian’ COVID-19 restrictions | One America News Network	Non-candidate
t3_jy3nl0	Attorney Lin Wood: Georgia Woman Witnesses Shredding Company Shredding Ballots and Recycling Company Destroying Evidence at Elections Office in Cobb County	Non-candidate
t3_jy7mra	Conservative SCOTUS Justices Assigned to 4 of 6 Contested Election States	Non-candidate
t3_jxt0dz	Newsom Announces Curfew So He Won't Have To Wait In Long Line At Fancy Restaurants	Non-candidate
t3_jy41hq	Sidney Powell: Evidence of vote-fraud 'conspiracy' to be published -- Documents will be posted online as soon as this weekend	Non-candidate
t3_jydflq	Midnight Train to Georgia? -- It is hardly surprising that progressive standard bearers are urging their fellows to winter in Georgia, register, and vote—before presumably decamping on January 6 to tell their friends of their heroic deeds.	Non-candidate
t3_jy4r1n	Georgia Governor Calls for Audit of Signatures on Ballot Envelopes	Non-candidate
t3_jxqx1x	GOP Win In PA: Judge Tosses Thousands Of Ballots Without Dates, Reversing Lower Court Ruling	Non-candidate
t3_jxzwbe	Nikki Haley Asks AOC How Will She Pay for Green New Deal When She Wants to Pay People Not to Work	Non-candidate
t3_jye9tl	LIMBAUGH: The Censorious Left Is Obliterating Free Speech	Non-candidate
t3_jxwx2d	Why have over 100 Dominion employees deleted their profiles on LinkedIn? – Headlines 360	Non-candidate
t3_jxog87	College deletes Instagram post spotlighting Republican student after fellow students complain conservatives are dangerous, want to kill black people	Non-candidate
t3_jyi40z	Outside Groups Flooding Georgia with Ad Buys Before Senate Runoffs	Non-candidate
t3_jxzkim	Kevin McCarthy letter urges 23 House Dems to bypass Nancy Pelosi and deliver COVID-19 relief for America	Non-candidate
t3_jy9z5t	What's Now at Stake Is The Rule of Law	Non-candidate
t3_jxw4a9	Ohio Just Shut Down Their Republican Governor – House Passes Bill To Keep Him From Closing Non-Essential Businesses	Non-candidate
t3_jyfh7c	Sorry, 1619 Project, But the Mayflower Was Far More Pivotal to American History	Non-candidate
t3_jy8v1a	Oregon Business Owners: State Officials Know Lockdowns Do Not Slow the Spread of Coronavirus, But They're Doing Them Anyway.	Non-candidate
t3_jy29fl	No Tucker, That's Not How This Works -- Simply put Mr. Carlson, demanding someone come on your show or else you’re writing them off is how the left operates.	Non-candidate
t3_jy8lyb	Should Conservatives Be Reeducated? Maybe So, According to a DNC Official	Non-candidate
t3_jxqjdc	CNN Accuses Parler As 'Threat To Democracy' Amid Facebook, Twitter's Censorship, Political Bias	Non-candidate
t3_jygbbr	Hard-to-find 2020 election fraud stories and links	Non-candidate
t3_jyhleq	Media and Democrats Decide They Love Forever War Now Because Orange Man Bad	Non-candidate
t3_jy45yn	Sidney Powell's recent interview with Howie Carr...rather DISTURBING news if there is evidence. You should listen.	Non-candidate
t3_jyi558	Federal Court Strikes Down Florida LGBTQ Counseling Ban -- Struck down laws that prohibit mental health professionals from counseling children and teens who are troubled by unwanted same-sex attractions or gender dysphoria.	Non-candidate
t3_jy17rm	Horror in Chicago: Bullet hits 5-year-old boy in the head as he sat on the couch playing on an iPad.	Non-candidate
t3_jy8kkz	Colin Kaepernick goes full radical with call to free cop killer	Non-candidate
t3_jxy1at	WISN | Kyle Rittenhouse released from Kenosha County Jail	Non-candidate
t3_jxqzln	Hungary Proposes Amendment to Protect Children's Biological 'Sex' and 'Christian' Upbringing	Non-candidate
t3_jyi398	Stacey Abrams’ Group Dropping $2.7 Million Ahead of Georgia Senate Runoffs	Non-candidate
t3_jxs8yk	Some California Sheriffs Are Telling Gov. Newsom to Shove It on His New Lockdown Orders	Non-candidate
t3_jxzgec	Dominion Voting Systems ‘Lawyers Up,’ Abruptly Backs Out of PA State House Fact-Finding Hearing	Non-candidate
t3_jxoif7	Tucker Carlson: Time for Sidney Powell to show us her evidence	Non-candidate
t3_jy300d	Supreme Court Reveals New Circuit Assignments for Justices — What You Need to Know. Look who’s in charge of WI,MI,PA,and GA 😉😉	Non-candidate
t3_jyflun	Andrew Cuomo Thinks He Can Ban Thanksgiving	Non-candidate
t3_jy1y2q	Andrew Cuomo To Get An Emmy For Televised COVID-19 Briefings	Non-candidate
t3_jybkhl	Court: Tennessee Can Enforce Down Syndrome Abortion Ban	Non-candidate
t3_jy9w0g	No, State Legislatures May Not Reverse the Result of the Election. If state lawmakers wished to end or disregard popular elections, they would have to repeal current law. That would be unfathomable.	Non-candidate
t3_jxw35p	Sidney Powell: Will Prove Case 'Within Next Two Weeks' in Court	Non-candidate
t3_jydpl3	Former U.S. Senator Roger Jepsen dies at 91	Non-candidate
t3_jy5s18	Group bankrolled by George Soros and Michael Bloomberg pours hundreds of thousands of dollars into Georgia runoff elections	Non-candidate
t3_jye9q5	Why the GOP Should Be Optimistic After 2020 Election	Non-candidate
t3_jy4wvg	Cancel student-loan debt? That’s making the working class subsidize the elite!	Non-candidate
t3_jyaahm	The High Cost of Beijing's Demands for Uniformity -- Why is Beijing so hostile toward those looking to practice their faith according to their conscience?	Non-candidate
t3_jxu6vq	Divided Pennsylvania House gives approval for audit of 2020 election	Non-candidate
t3_jxpoun	Plans to disarm Portland State campus police on hold after too many quit	Non-candidate
t3_jxrcyk	Dominion voting software can permit staff to manually adjust ballot returns during counting process	Non-candidate
t3_jxzu8m	Kyle Rittenhouse Released from Jail on $2 Million Bond	Non-candidate
t3_jy52ux	Levin: 'The Quantity of Fraud Is Not the Test'	Non-candidate
t3_jy1p41	BREAKING: Kyle Rittenhouse Posts $2 Million Dollar Bail -- Big Tech Shut Down His Social Media Accounts With No Verdict In Sight	Non-candidate
t3_jybzm8	Student Loan Losses Seen Costing U.S. More Than $400 Billion. Projected toxic debt approaches subprime-mortgage losses incurred by lenders during financial crisis	Non-candidate
t3_jxtwdv	Atty. Jenna Ellis Tells Reporters: If You Were Jurors, ‘I’d Strike 99% of You’ and ‘Get Unbiased Jurors’	Non-candidate
t3_jy7pu5	Nikki Haley shuts down Ocasio-Cortez over her solution to the pandemic, and she is not happy about it	Non-candidate
t3_jy5s9z	U.S. Considers Moving Forces Out of Somalia	Non-candidate
t3_jxw6kh	WATCH: Kayleigh McEnany Heckled During Presser, Tells Badgering Reporters: ‘I Don’t Call On Activists’	Non-candidate
t3_jxqwo5	I Won’t Arrest You For Celebrating Thanksgiving, And No Good Cop Would -- Many police offers I know are using their discretion to refrain from strictly enforcing sanctimonious and unconstitutional edicts amid a moral panic.	Non-candidate
t3_jxzx5m	John James Calls on Michigan Board of Canvassers to Delay Vote Certification, Investigate Ballot Counting	Non-candidate
t3_jxqh24	Unity Strikes Again: Cancel culture calls on Disney to fire Star Wars actress for wanting free and fair elections	Non-candidate
t3_jy7gct	Protesters in NE Portland break windows at Whole Foods, other businesses	Non-candidate
t3_jxtbqa	Head of prestigious school calls MAGA hat 'symbol of racism and hatred' after student wears one: 'He will not wear it again'	Non-candidate
t3_jxyi39	Tom Cotton: This Time Is Not for Politicians, Press Conferences -- Time for Evidence in Court	Non-candidate
t3_jy4i6s	Immune cells for common cold may recognize SARS-CoV-2	Non-candidate
t3_jxwis1	GOP Woman Who Wants Certification Of Wayne County Votes Rescinded Says MI Man Published Her Home Address Online	Non-candidate
t3_jy6mq9	Court: Tennessee Can Enforce Down Syndrome Abortion Ban	Non-candidate
t3_jy0i9v	BREAKING: Don Jr. Tests Positive For COVID-19	Non-candidate
t3_jxs2sv	630k Doctors Scientists and Citizens have signed the Global Anti-Lockdown Petition	Non-candidate
t3_jxulu9	Divided Pennsylvania House gives approval for audit of 2020 election	Non-candidate
t3_jxodvk	Democrats say NO to Thanksgiving, while Oregon decriminalizes Methamphetamine	Non-candidate
t3_jycujs	The Democratic Impulse of the Scholars in Nietzsche’s “Beyond Good and Evil” - VoegelinView	Non-candidate
t3_jy0u0e	South Dakota Wins 2020 Top U.S. Holiday Travel Destination	Non-candidate
t3_jy0wft	As treatment improves, White House notes sharp drop in COVID death rates among elderly, middle-aged	Non-candidate
t3_jy8jxe	Democrats in Congress, for 40th time, obstruct stimulus bill plans	Non-candidate
t3_jy9koe	Sen. Dianne Feinstein Seen Maskless in Public	Non-candidate
t3_jxrte0	CDC Director: Schools Among ‘Safest Places’ Kids Can Be, Closing Schools An ‘Emotional Response’ Not Backed By Data	Non-candidate
t3_jxoe3m	Kyle Rittenhouse doesn’t regret bringing a gun to Kenosha riots: ‘I would’ve died that night if I didn’t’	Non-candidate
t3_jxtut8	Dominion Cancels Planned Appearance Before Pennsylvania Lawmakers	Non-candidate
t3_jyik3v	Sidney Powell has expanded on the scope of the Dominion scam	Non-candidate
t3_jy1dgc	New York's 'Vote Counting Debacle' -- More than two weeks after Election Day, New York is still counting votes.	Non-candidate
t3_jyiisi	Green Card Holder in Nevada Received Mail-In Ballot	Non-candidate
t3_jxvxyo	Michigan Governor Is In Impeachment Trouble – Whitmer’s Own Legislature Introduces Resolution To Remove Her	Non-candidate
t3_jxuved	Georgia Officials Investigating After Old Voting Machines Found Dumped Near Savannah	Non-candidate
t3_jxrjw2	Politicians Aren't Canceling Their Gatherings, And Neither Am I	Non-candidate
t3_jyckf8	Section-1-The-BREATHE-Act-Summary (as a conservative in Congress, how could you agree to the de-criminalization of human trafficking being proposed in this plan?)	Non-candidate
t3_jxynam	Pennsylvania GOP Slams Dominion Systems For Canceling On Giving Testimony	Non-candidate
t3_jy5pya	Danish study: Face masks have no significant effect	Non-candidate
t3_jxodhp	Your Political Leaders Hate You And Think You’re Stupid	Non-candidate
t3_jy15y8	Kyle Rittenhouse released after posting $2 million bail	Non-candidate
t3_jxvhbv	Rep. Jody Hice: Georgia Ballots Must Be Audited with Signature Verification of Absentee Ballots	Non-candidate
t3_jy5rf6	Matthew Parris: Talk of ‘beating Covid’ was always nonsense (we need to learn to live with it)	Non-candidate
t3_jxypnf	Sidney Powell Claims that Dominion Is 'Shredding Documents'	Non-candidate
t3_jxoee1	Washington Gov. Inslee bans singing in church. Broadway celeb responds: I'm not going to comply with your 'unlawful orders.'	Non-candidate
t3_jy2fvn	"Screaming about ""White Privilege"" in the streets, but ""Colonized"" in the sheets"	Non-candidate
t3_jxobw8	French President Emmanuel Macron issues ultimatum to Muslim leaders after lethal terrorist attacks	Non-candidate
t3_jy6yw8	Judge rejects Derek Chauvin divorce, citing possibility of fraud	Non-candidate
t3_jxy5kq	NY company makes window stickers of Cuomo watching over your Thanksgiving	Non-candidate
t3_jxvj1b	Sidney Powell: Will Prove Case 'Within Next Two Weeks' in Court	Non-candidate
t3_jy5h9o	California Rep. Tom McClintock blasts Newsom and others for lockdown policies	Non-candidate
t3_jxxz0b	Secretary of State's Office certifies Georgia's 2020 election results	Non-candidate
t3_jxwj2z	Sidney Powell: Evidence of voter fraud could be released online 'by this weekend'	Non-candidate
t3_jy9lmm	California entertainment workers exempted from Gov. Newsom's stay at home orders	Non-candidate
t3_jxofru	San Francisco has a new pollution problem thanks to the pandemic: Used masks, gloves, and other PPE litter the Bay Area	Non-candidate
t3_jxr43d	George Soros Says Irritating Conservatives Makes Him ‘Happy’ In New Documentary About His Life	Non-candidate
t3_jy1d64	Judge denies bond reduction for woman accused of shooting JSO officer during raid	Non-candidate
t3_jy67e0	Angelo Codevilla: From Ruling Class to Oligarchy (half the country is living under a regime that means to harm us)	Non-candidate
t3_jxwtn6	Georgia Officials Investigating Voting Machines Dumped Roadside Near Savannah GA	Non-candidate
t3_jxzmfc	Walmart and McDonald’s have the most workers who rely on federal aid to make ends meet, such as food stamps and Medicaid – Report	Non-candidate
t3_jy3nvf	Current List of Dominion Related Fraud	Non-candidate
t3_jxvfto	Kayleigh McEnany to Interrupting Reporter: 'I Don't Call on Activists'	Non-candidate
t3_jxz65q	Kenosha kid Kyle Rittenhouse has been bailed out	Non-candidate
t3_jxub1t	GOP Win In PA: Judge Tosses Thousands Of Ballots Without Dates, Reversing Lower Court Ruling	Non-candidate
t3_jxwwin	Democrats Push To Keep Schools Closed So Kids Will Be Dumb Enough To Accept Socialism	Non-candidate
t3_jyimqh	This is a picture that should not exist. But here we are in 2020.	Non-candidate
t3_jy1jwi	Circuit Assignments - Supreme Court of the United States	Non-candidate
t3_jy569v	Johnson &amp; Johnson ordered to pay $120M to a woman after she blamed her cancer on exposure to company's baby powder	Non-candidate
t3_jxp82q	Senator On If Democrats Win GA Senate Seats: ‘Imagine Living In A World Designed By The Post Office’	Non-candidate
t3_jxp5na	Politicians Aren’t Canceling Their Celebrations And Gatherings, And Neither Am I -- I will not be lectured by people who say that eating in a restaurant with health protocols is riskier than shutting down the largest economy in the world.	Non-candidate
t3_jxtsuw	DeKalb County elections manager fired for errors found in ballot audit	Non-candidate
t3_jxz3bj	Churches Push Back Against Coronavirus Restrictions	Non-candidate
t3_jxy28b	Here Is The Evidence: 2020 Voter Fraud	Non-candidate
t3_jxzxqa	Democrats Push To Keep Schools Closed So Kids Will Be Dumb Enough To Accept Socialism	Non-candidate
t3_jxyhat	Scalise: GOP Gave Moderate Dems Chance to Vote with Us for the Last 2 Years; They Voted with Pelosi, AOC 90% of the Time	Non-candidate
t3_jy1nlv	Republican Mayor in SD sounds interesting as a Moderate to kick out Newsome....	Non-candidate
t3_jy6940	Jim Geraghty: Obama’s Simmering Resentment of Benjamin Netanyahu	Non-candidate
t3_jy3u8w	AOC apparently missed the budget line items that fund local law enforcement...not sure how she classifies the FBI	Non-candidate
t3_jyhj8z	Nevada: Total Ballots Cast: 1,327,394, Total Presidential Election Votes: 1,405,376	Non-candidate
t3_jy0lgo	California’s Gavin Newsom just proved himself a hypocrite and a liar	Non-candidate
t3_jy0rkg	Governor Preen. California’s Gavin Newsom presides with aristocratic hauteur over a state in crisis.	Non-candidate
t3_jxqxtt	If I Can Pay Off My Debt By Controlling My Spending, So Can Other People -- Long before the coronavirus hit our shores, our society’s focus on instant gratification has in many respects made acts of self-sacrifice a lost art.	Non-candidate
t3_jxwk3g	Twitter launching exciting new feature! (White men need not apply)	Non-candidate
t3_jxxnio	Tim Pool: Evidence Of Widespread Voter Irregularity Just Dropped, Republicans Votes MISSING	Non-candidate
t3_jxodib	Steven Crowder says this is why more than 150-thousand Michigan votes could be suspect	Non-candidate
t3_jxodc8	Alleged Whitmer kidnapping plotters also planned televised killings of lawmakers, torching capitol: Michigan AG	Non-candidate
t3_jxcf5f	Fox News’ Ratings Tank After Election Night, Down Nearly 40% | The Daily Wire	Non-candidate
t3_jy9bm1	"""PLEDGE Allegiance to The NEW WORLD ORDER"""	Non-candidate
t3_jxqdct	California Dem Official Wonders How To ‘Deprogram’ Conservatives Like In ‘Post-WWII Germany’	Non-candidate
t3_jy1udg	Dominion Voting Systems shared office is INCUBATOR for radical left-wing organizations [Video Proof]	Non-candidate
t3_jxyq3c	Lt. Gen McInerney enters the voter fray: Dems used Intelligence software	Non-candidate
t3_jy5s1e	John Turner: The Mayflower Compact 400 Years Later	Non-candidate
t3_jxoh4d	Oklahoma megachurch organizes mass Thanksgiving meal for congregation of thousands: 'Bring a neighbor'	Non-candidate
t3_jxv5nd	FOX 11 obtains exclusive photos of Gov. Newsom at French restaurant allegedly not following COVID-19 protocols	Non-candidate
t3_jxz3zu	Fareed Zakaria: The World Needs American Idealism Again	Non-candidate
t3_jyfs3m	GOP Senate candidate asks for delay in Mich. election results | One America News Network	Non-candidate
t3_jxxg9d	Michigan: “We can’t see any physical way possible for some of those votes” [VIDEO]	Non-candidate
t3_jxpaf9	"The Exemption in Gov. Newsom's Lockdown Order That Exposes Its Absurdity -- Entertainment industry workers exempt, considered ""essential workers"""	Non-candidate
t3_jy8jtz	Web searches for ammo 'reloading'surge amid election chaos	Non-candidate
t3_jy1ck9	Remember When the UN Declared the Unborn Should Be Protected?	Non-candidate
t3_jy5aan	Nike Social Media Influencer Kaepernick Praised Mumia For The Spotlight	Non-candidate
t3_jxyiim	"Reporter yells out, ""When will you admit you lost the election?"" to Press Sec. Kayleigh McEnany"	Non-candidate
t3_jy5p6q	Chris Caldwell: The President’s big flaw was terrible hiring	Non-candidate
t3_jxocp3	'You're a bunch of Socialists': Lindsey Graham torches far-left lawmakers calling on him to resign	Non-candidate
t3_jxwxfg	Parents Group Issues Warning for Parents: Parler inappropriate and dangerous for minors	Non-candidate
t3_jxvl41	Fox News Calls Giuliani Liar After Conference	Non-candidate
t3_jxod13	California Gov. Newsom issues lockdown order over coronavirus spike; one sheriff from a large county has already refused to enforce it	Non-candidate
t3_jxofjc	Tom Cotton blasted as a 'racist piece of trash' for criticizing NYT article describing 'cruel history' of Thanksgiving	Non-candidate
t3_jxy4b9	China Promotes Study Claiming Coronavirus Found in Italy Before Wuhan	Non-candidate
t3_jxyfyl	Dominion Agreement With Santa Clara County Allows Staff to ‘Adjust Tally’	Non-candidate
t3_jy089j	Hillary Clinton Says Christianity Must ‘Take a Hard Look At Itself’ and Join the BLM ‘Moral Awakening’	Non-candidate
t3_jxcj37	New Committee to AOC: 'We Don't Do Enemies Lists in America!'	Non-candidate
t3_jxs57v	WH Trade Adviser Peter Navarro Warns Lockdowns Are a ‘Regressive Tax’ on the Poor	Non-candidate
t3_jy0avf	Kyle Rittenhouse released on $2M bond after shot two dead at protest	Non-candidate
t3_jxsnch	Entertainment Industry Workers Exempt From California Governor Gavin Newsom’s New Stay-At-Home Order	Non-candidate
t3_jxy48p	BLM pressures Democrats to embrace bill described as 'roadmap for prison abolition'	Non-candidate
t3_jycp36	What’s the Matter with Hispanics? | Latino voters surprised (and disappointed) progressive observers on November 3 because they are more likely to respond to economic issues than identity politics.	Non-candidate
t3_jxu9ra	California Sheriff Announces His Refusal To Enforce Gov. Newsom’s Coronavirus Restrictions	Non-candidate
t3_jxrg6a	Sidney Powell: Tucker Carlson 'Insulting, Demanding, and Rude'	Non-candidate
t3_jxz0wn	Georgia Governor Kemp News Conference on Election Results Certification	Non-candidate
t3_jybycl	In defense of RealClearPolitics	Non-candidate
t3_jxtwxg	Congresswoman-Elect Marjorie Greene: ‘Congress Is Just Broken, and Everyone Is Tired of It’	Non-candidate
t3_jxgdv0	Republicans won all 27 House races listed as 'toss-ups' — and then some	Non-candidate
t3_jxxcpx	Georgia Secretary of State sends press release saying it certified election results, corrects itself just minutes later with second press release confirming it didn't	Non-candidate
t3_jy5gq1	Trends in County-Level COVID-19 Incidence in Counties With and Without a Mask Mandate — Kansas, June 1–August 23, 2020	Non-candidate
t3_jy02vx	Federal Circuit Court Rules Bans on LGBT Conversion Therapy for Minors Unconstitutional. A court split between Florida and California may mean an eventual Supreme Court decision.	Non-candidate
t3_jxyg3v	Left Attacks Scott Atlas For Saying Same Things About COVID As The New York Times, Six Months Earlier	Non-candidate
t3_jxscw7	Wearing a mask alone in public defies science	Non-candidate
t3_jy3pee	EXCLUSIVE: Sidney Powell - Examining Politics - Omny.fm	Non-candidate
t3_jxhvr3	Hungary Proposes Amendment to Protect Children's 'Biological Sex' and 'Christian' Upbringing	Non-candidate
t3_jxy7ja	Gov. Andrew Cuomo to receive Emmy award for his 'leadership' during the pandemic	Non-candidate
t3_jxxv6n	Cuomo to get Emmy for use of TV during COVID-19 pandemic	Non-candidate
t3_jygqie	Do some people have hidden immunity against COVID?	Non-candidate
t3_jy0pfg	Marjorie Taylor Greene, Ilhan Omar and Kelly Loeffler Get into a Twitter Brawl	Non-candidate
t3_jxx9as	Pfizer and BioNTech Submit Requests for COVID-19 Vaccine Emergency Use Authorization	Non-candidate
t3_jxniw8	Decreases In School Crime Are Concurrent With Increases In Police School Resource Officers	Non-candidate
t3_jxysrc	Poland PM: EU a “eurocrat” oligarchy in the interest of Germany and France	Non-candidate
t3_jxofai	Video shows brutal attack on older woman who asked a young couple to put on masks before joining her in elevator	Non-candidate
t3_jxvj9h	Watch LIVE: Stop The Steal Protest in Atlanta, GA- LIVE COVERAGE - Right Side Broadcasting Network	Non-candidate
t3_jx6lod	US Envoy: China Is ‘One of the Worst’ Religious Persecutors in the World, ‘If Not the Worst’	Non-candidate
t3_jxwrxw	Circuit Assignments - Supreme Court of the United States	Non-candidate
t3_jyby0o	Trump Announces Groundbreaking Rules to Lower Prescription Drug Prices	O
t3_jyaufj	Berkeley professor sparks outrage by claiming Trump supporters who have an 'indifference' to COVID are like Germans who 'ignored and profited from the Holocaust'	O
t3_jy56dt	Trump Announces New Regulations Lowering Prescription Drug Costs	O
t3_jydj00	LIVE: March for Trump in Atlanta, Georgia	O
t3_jybrmo	Joe Biden's 'Vote Joe' website defaced by Turkish Hackers	O
t3_jydzd2	Twitter says it will hand control of US president's official account to Joe Biden on January 20 - regardless of whether Donald Trump has left the White House	O
t3_jy9egu	Joe Biden loses it at reporter who asked about kids going back to classrooms - then tells press to leave	O
t3_jy248u	Anti-Trump Legal Team Withdraws In Pennsylvania	O
t3_jy4x55	Harvard Students Demand That Trump Officials Be Preemptively Barred From Campus	O
t3_jygwhl	Donald Trump Improved Standing With Latinos In 78 Of America’s 100 Majority-Hispanic Counties	GI
t3_jyfij4	Georgia Gov. Kemp Calls for Audit, Says Trump Can Demand New Recount	SE
t3_jy8qby	Joe Biden: Why Are Reporters Asking Me Questions? On Friday, Biden appeared dumbfounded as to why a reporter was asking the projected Democratic presidential-elect a question as the press pool was being scurried away by staff.	O
t3_jy2icm	Donald Trump Jr. tests positive for COVID-19	O
t3_jygs96	Merkel's Germany Tells Trump Not to Bring Troops Home from Afghanistan	FR
t3_jyhhtr	McEnany: Trump's path to victory is Supreme Court, exposing 'systemic' voter fraud	SE
t3_jybfam	BLM, Squad members pushing Dems, Biden to abolish prison	GI
t3_jy1csd	Hispanic Voters in Florida Feel Election Was Stolen from Trump	SE
t3_jyb4tl	6 Big Claims by Trump’s Lawyers About Overturning Election Results	SE
t3_jyd2rr	Watch: Sidney Powell – Millions of DEAD People Voted! 7 Million Votes STOLEN From Trump!	SE
t3_jybaah	Rudy and Sidney’s Krakentastic Spectacle, and What It Could Mean -- A dismissive legacy media might have panned Team Trump’s press conference Thursday, but it was a significant moment with significant portents.	O
t3_jyf2js	Biden says in video he has created 'voter fraud organization'	SE
t3_jygoog	Trump voters back the President’s charges of election fraud led by Democrats	SE
t3_jychbs	Ben Carson credits Trump's action after becoming 'desperately ill' with COVID: 'Saved my life'	O
t3_jy240e	How Christianity Gained Cultural Momentum In The Trump Era -- Some celebrities are not just talking the talk, but they seem to be walking a walk that seems to counter what Hollywood culture promotes and accepts.	O
t3_jyc5wq	Bo Erickson of CBS asks Biden about his son. He says it's just a smear campaign.	FR
t3_jygabf	Ilhan Omar Urges Biden To ‘Reverse’ President Trump’s Middle East Agreements	FR
t3_jyhsxr	Brian Williams mocks Geraldo Rivera suggestion to name COVID-19 vaccine after Trump	O
t3_jy8kt6	Obama to produce Netflix series about Trump transition, unclear whether it will include abusing intel agencies to spy on successor	O
t3_jxocbx	[Not Satire] National Democratic Party official suggests re-education for Trump supporters: 'How do you deprogram 75 million people?'	O
t3_jyfjr4	Trump Objects to Counting Thousands of Wisconsin Ballots	SE
t3_jy16dv	New Senate Report Confirms Hunter Biden's Biz ties to CCP, Raises Troubling Ties to Kremlin	FR
t3_jy6x6f	Whatever Happens In The Next Few Weeks, Brothers and Sisters, Remember This Clip, My Favorite 60 seconds of Trump: 'I am your voice'	O
t3_jy44lw	Trump Leads Voyage Of Pilgrims To Greenland To Establish Even Better America	O
t3_jy6h4r	Romney on Trump election tactics: 'Difficult to imagine a worse, more undemocratic action' by president	SE
t3_jy0pv9	Chris Evans and Zach Braff Encourage Keeping Track of Trump ‘Enablers’	O
t3_jy0m21	Donald Trump returns to the White House briefing room claiming he 'won' and suggests Pfizer held back vaccine to sabotage his election and says without him the drug would have taken four YEARS	O
t3_jy47z9	Biden Mocks a Reporter for Asking a Question as Biden's Staff Tries to Get the Press Out of There	O
t3_jy1crk	Trump Touts New Rules to 'End Global Free Loading' of Prescription Drugs	O
t3_jxod6m	'No national shutdown': Joe Biden says shutting down the virus will not require a national lockdown	WA
t3_jy17l6	"""Kayleigh McEnany Obliterates Both Dems, Media for Hypocrisy Over Election Results, Completely Levels CNN Reporter: """"Where were the calls for unity and a peaceful transition when President Trump was elected in 2016?"""""""	O
t3_jxnh2b	Lawyer working on Trump Pennsylvania effort placed under official protection due to threats	O
t3_jy0vje	Trump's daughter-in-law Lara reported to be considering 2022 Senate run	O
t3_jy0aqe	BLM Co-founder: Biden's election was 'won by Black people', 'We want something for our vote.'	GI
t3_jxochk	New Senate report purportedly 'confirms' Biden family's business ties to Chinese, Russian governments	FR
t3_jxrzlp	Obama Tells Jimmy Kimmel: 'We Can Always Send the Navy SEALS' to Remove Trump from White House	SE
t3_jxzw8k	Donald Trump: ‘Big Pharma’ Purposely Delayed Coronavirus Vaccine Until After Election	O
t3_jy2rb5	Trump lifts travel ban on Chad	O
t3_jxsfmb	Whoa: Nearly a Third of Democrats Believe the Election Was Stolen From Trump	SE
t3_jxrnvy	Tucker Carlson​ says Trump attorney Sidney Powell wouldn't provide him with any evidence of election fraud. Powell hits back.	SE
t3_jxxtr7	Trump lawyers cited Minnesota counties in affidavit about Michigan: report	SE
t3_jxuonz	Elected DNC Member Floats Re-Education Camps for Trump Supporters	O
t3_jxx2eu	Nancy Pelosi calls Trump a 'Psychopathic Nut'	O
t3_jy0dkc	Donald Trump Jr. tests positive for COVID-19	O
t3_jy0f6f	Donald Trump Jr tests positive for coronavirus	O
t3_jy3xhk	Catholics sounding alarm about Biden administration, conflicts with moral teachings	WA
t3_jy1cs3	Bigot: Joe Biden Lackey Wanted to Destroy Amy Coney Barrett Because She's Catholic	GI
t3_jxsv1q	Trump Campaign Fact-Checks the Media: Georgia Has Not Certified Biden's Win	GR
t3_jy1cr9	Gregg Jarrett Has an Important Reminder for the Media About the Trump Campaign's Evidence of Voter Fraud	SE
t3_jy0ud9	‘Enormously insulting’: Sanders warns Biden not to shut out progressives	WA
t3_jxtmra	'We are a nation of laws, not tweets': Republican Sens. Romney and Sasse decry Trump efforts to challenge election	SE
t3_jy6i8u	Omar suggests Biden should 'reverse' Trump's Middle East agreements, says they 'weren't peace deals'	FR
t3_jycsny	WATCH: Obama On Trump: ‘We Can Always Send The Navy SEALs In There To Dig Him Out’	SE
t3_jxtoaq	Georgia certifies election results, making Biden win official	GR
t3_jxvx68	Biden stuggles with words at press conference -- 'I'm going to ... employ the defense, reconstruct the act'	O
t3_jxny9j	Trump Legal Adviser Jenna Ellis Rips Media: ‘You Are Not Unbiased Jurors’	O
t3_jxxelw	Trump Appears To Doubting Tucker And Lets Him Touch The Fraudulent Ballots Himself	SE
t3_jxsxuq	National Democratic Party official suggests re-education for Trump supporters: 'How do you deprogram 75 million people?'	O
t3_jxz4ek	Biden to Impose $200 Gun Tax | Americans for Tax Reform	WA
t3_jxo83f	Hunter Biden had deep business ties with communist party-linked Chinese tycoon: new Senate report	FR
t3_jxq1j3	Joe Biden stays silent over proposed meeting with BLM founder	GI
t3_jy0cbd	Opinion | Georgia Certifies: Donald Trump Lost	GR
t3_jxvhyz	Lin Wood: President Trump won 400 electoral votes | One America News Network	SE
t3_jxuoli	Biden certified Georgia winner after hand recount	GR
t3_jy0r0u	Obamas producing Netflix anti-Trump comedy show	O
t3_jxtalp	Intimidation Tactics Against Trump Lawyers Undermine Justice	O
t3_jxxjgh	Giuliani, other Trump lawyers to skip meeting with Michigan lawmakers after COVID-19 exposure	O
t3_jxow0s	Satire: Obama: 'Biden Has Touched Us All'	O
