Name	title	coding
t3_j9346j	/r/Conservative Official Political Discord	Non-candidate
t3_jyvyjh	China now blaming Italy for starting Wuhan coronavirus pandemic	Non-candidate
t3_jyvht8	HBO talkshow host Bill Maher slams Democrats for hypocrisy on COVID-19 protocol -- ‚ÄúThey keep getting caught doing what we‚Äôre not allowed to do.‚Äù	Non-candidate
t3_jyufp9	Latinos in South Texas Voted Against Illegal Immigration and CBP Demonization	Non-candidate
t3_jyxn8u	New York Democratic Leaders Caught Maskless At Private Party Despite COVID Restrictions	Non-candidate
t3_jyxkr4	AOC: Does anyone believe Rittenhouse would be released if he were Muslim &amp; did the same thing in a diff context? For people who say ‚Äúsystemic racism doesn‚Äôt exist,‚Äù this is what it looks like: protection of white supremacy baked deep into our carceral systems.	Non-candidate
t3_jyzxbg	Black Lives Matter Wisconsin leader - a convicted felon - arrested on suspicion of sexual assault	Non-candidate
t3_jynr36	High family income, not SAT scores, is your real ticket to Harvard, Yale, and Princeton	Non-candidate
t3_jywe6w	Joseph Stalin To Receive International Emmy For His Outstanding Hunger Relief Efforts	Non-candidate
t3_jyxdkn	Iowa's GOP Miller-Meeks Leads By 50 Votes In Nation's Closest House Race	Non-candidate
t3_jyz5xv	CA-25: Garcia(R) declares victory, Smith declines to concede	Non-candidate
t3_jyxedz	"Illinois Governor Pritzker Snubs Lori Lightfoot's ""Do Not Travel"" Advisory. He May Leave Chicago For Thanksgiving"	Non-candidate
t3_jyy03k	Brooklyn political elite ignore COVID-19 rules at birthday party for Carlo Scissura	Non-candidate
t3_jz1ccx	Gov. Kemp calls for signature audit of Georgia vote	Non-candidate
t3_jz310n	Viral video shows New York business owners take defiant stand when health inspector barges inside: 'Go get a warrant'	Non-candidate
t3_jyuins	An Urgent Appeal to WHO: Let Taiwan Speak -- If WHO is serious about the pandemic, it will listen to the nation that successfully confronted it ‚Äî and stop kowtowing to Beijing.	Non-candidate
t3_jz2v7v	"Let's talk about the ""where is the evidence"" meme"	Non-candidate
t3_jyxknb	Subway shoving, flamethrowers, shootings in NYC blamed on 'perfect storm' of police reform, pandemic. Shootings have almost doubled from last year following a long era of low crime rates	Non-candidate
t3_jywrgm	Remember when: Activists urge Clinton camp to challenge election results in three states	Non-candidate
t3_jz32ou	Left-Wing Activist And Actress Alyssa Milano Warned Against Electronic Voting Machines in 2018: ‚ÄòWe Need Paper Ballots‚Äô	Non-candidate
t3_jyjvag	HBO‚Äôs John Oliver Called It ‚ÄòCompletely Insane‚Äô to Use Electronic Voting Machines in Nov. 2019	Non-candidate
t3_jyxejf	Merkel, Germany's 'eternal' chancellor, marks 15 years in power	Non-candidate
t3_jz0yll	AOC slams Kyle Rittenhouse‚Äôs release on $2M bond as ‚Äòlaw and disorder‚Äô	Non-candidate
t3_jyvnfu	"McEnany: We Have To Take Election To The Supreme Court To Expose ""Systemic Voter Fraud"""	Non-candidate
t3_jyyqsb	Leftists Hate on Free Speech Platforms GAB and Parler: Where is this Going?	Non-candidate
t3_jz2zwz	Sidney Powell Is an American Legal Giant -- She is fighting for our Republic right now because ‚Äì make no mistake ‚Äì honest American elections, and the continuing viability of our democracy, is on the line.	Non-candidate
t3_jyo646	Poll shows Republican favorability of Fox News has dropped after Election Day	Non-candidate
t3_jyu9da	Sacramento Sheriff on Not Enforcing COVID Curfew: Making Cops 'Instruments' of 'Oppression' Damages Community Relations	Non-candidate
t3_jz458k	"""Georgia Is the First State I‚Äôm Going to Blow Up and Mr. Kemp and the Secretary of State Need to Go With It!‚Äù ‚Äî Sidney Powell"	Non-candidate
t3_jyzr94	WaPo Columnist Has an Epic Meltdown Over Republicans Standing By Claims of Voter Fraud	Non-candidate
t3_jyxbza	Polish Prime Minister: EU ‚ÄòOligarchy‚Äô Wielding ‚ÄòPropaganda Bludgeon‚Äô Like Former Communist Regime	Non-candidate
t3_jyuepe	NY company makes window stickers of Cuomo watching over your Thanksgiving	Non-candidate
t3_jz2tk2	Kevin McCarthy: Voters Have Rejected Pelosi's 'Socialist' Agenda	Non-candidate
t3_jz1ohl	Data Analysts: Stolen votes confirmed by voters themselves	Non-candidate
t3_jyxe43	Marsha Blackburn: Big Tech Censorship 'Choosing Winners And Losers'	Non-candidate
t3_jyni11	NY Business Owners Kick Out Health Dept, Sheriffs: ‚ÄúCivil Disobedience Starts Now‚Äù	Non-candidate
t3_jyhqpn	"Waffle House‚Äôs Stand Against Lockdowns Is Exactly What America Needs‚ÄîAlmost | ""None of the people who make the decisions to shut down businesses and impact people's livelihoods ever have their own livelihood impacted,"" the Waffle House CEO recently told Business Insider."	Non-candidate
t3_jz29z4	Man spits on hikers for not wearing a mask	Non-candidate
t3_jypglr	Ohio Shifts Red: Analysts Believe Buckeye State No Longer Swing State	Non-candidate
t3_jyzfq8	U.S. retailer Guitar Center files for bankruptcy	Non-candidate
t3_jyp9sd	"Illinois Voter: ""You Don't 'Install' a President, You Elect a President"""	Non-candidate
t3_jz44zr	GOP Likely to Gain Third US House Seat in California	Non-candidate
t3_jygcv2	Joseph Stalin To Receive International Emmy For His Outstanding Hunger Relief Efforts	Non-candidate
t3_jyqhw1	REVEALED: Dominion/Smartmatic 'Noncompete' Agreement Emerges Despite Claims of Being 'Fierce Competitors'	Non-candidate
t3_jylcn2	2008 FlashBack: CNN Says Obama Won His Senate Primary by Tossing Ballots Without Matching Signatures	Non-candidate
t3_jyxcu1	Michigan Canvass Board Member: 'Need Evidence' to Delay Certification	Non-candidate
t3_jz36r2	To Restore Election Integrity, End Mail-In Vote Fraud	Non-candidate
t3_jz3jt3	The Fight Ahead: Our Media Is Trash. Their Words Are Worth Nothing. The fight ahead is real.	Non-candidate
t3_jz2pkg	Florida Holocaust museum opens exhibition about George Floyd	Non-candidate
t3_jz3yqv	Report: Al Sharpton's Charity Paid Relatives over $80K in 2019	Non-candidate
t3_jyp0f1	Sidney Powell: 'Biblical' Lawsuit Coming, Accuses Ga. Gov. Kemp of Deal With Dominion	Non-candidate
t3_jyxmvc	Huntington Beach protests California‚Äôs coronavirus curfew	Non-candidate
t3_jyyuuv	OUT: I Am Strong, I Am Invincible. IN: Boys Have Cooties! - Duke sorority council bans events with male groups.	Non-candidate
t3_jz30uh	Fauci Renews Pandemic For Highly Anticipated Season 2	Non-candidate
t3_jz4aea	Chris Christie Waddles to Lead the SurrenderCon Pack	Non-candidate
t3_jyyd3u	Kelly Loeffler quarantining after positive, inconclusive coronavirus tests: campaign	Non-candidate
t3_jyl2cx	Republicans fuming after Dominion Voting Systems backs out night before scheduled PA oversight hearing	Non-candidate
t3_jyyhla	Texan Matthew McConaughey Considering Political Run ‚Äì He‚Äôs Looking To Jump Straight To The Top As Governor	Non-candidate
t3_jz2lna	Britons who test negative for Covid set to receive a 'freedom pass'	Non-candidate
t3_jybw7n	Texas Passes Law Banning Californians From Voting After They Move There	Non-candidate
t3_jz3ai3	The Inauthenticity Behind Black Lives Matter	Non-candidate
t3_jybw1v	Don‚Äôt ‚ÄòCalifornicate‚Äô The Rest Of America	Non-candidate
t3_jyunfn	Gov. Andrew Cuomo to receive Emmy award for his 'leadership' during the pandemic, Twitter goes nuts	Non-candidate
t3_jyfm9t	Finally America is realizing that Andrew Cuomo is a putz	Non-candidate
t3_jywcd9	"Higher education cartoon of the week ""They pay You?"""	Non-candidate
t3_jyymdx	"Eleventh Circuit Enjoins Local Ordinances Barring ""Conversion Therapy"""	Non-candidate
t3_jyql4t	Chinese American Says the Left, Big Tech Reminds Him of Communist China	Non-candidate
t3_jyjz4y	"NY Business Owners Stand Up To Unconstitutional ""Lockdown"" Orders"	Non-candidate
t3_jyi8r3	CA-25 Republican Rep. Mike Garcia Claims Victory; Democrat Christy Smith Cries Foul	Non-candidate
t3_jyw3pi	Million MAGA March: Unravelling a Violent Viral Video	Non-candidate
t3_jykf6t	Just a reminder: Obama won his very first election by charging his opponents with election fraud. Oh, you didn't know?	Non-candidate
t3_jyy46n	What the Media Is Hiding About the DHS‚Äô Election Security Statement	Non-candidate
t3_jz4oh8	Religion, Liberty, and Religious Liberty. Macron is pushing France to confront the implications of Islamism for liberal democracy.	Non-candidate
t3_jyix1z	After 2,600 Uncounted Votes Turn Up In Georgia ‚Äì The Chief Elections Clerk Finds A Pink Slip Waiting For Him	Non-candidate
t3_jyjop2	Effort to recall Calif. Gov. Gavin Newsom granted 120 day extension to March 17 | One America News Network	Non-candidate
t3_jyl9yv	If We Want People To Accept A COVID-19 Vaccine, We Should Stop Lying To Them About The Disease	Non-candidate
t3_jywoz2	G20 Leaders Move To Distribute Covid Vaccines Fairly	Non-candidate
t3_jylrpb	Author Abigail Shrier faces threats after warning teen trans epidemic	Non-candidate
t3_jyfczv	Sacramento Sheriff on Not Enforcing COVID Curfew: Making Cops 'Instruments' of 'Oppression' Damages Community Relations	Non-candidate
t3_jz48az	Alinskyism On Steroids: The Great Election Fraud of 2020 -- Scott Lively sees 'corruption of biblical proportions that God alone can deliver us from'	Non-candidate
t3_jylr3z	Recall California Governor Gavin Newsom (2020)	Non-candidate
t3_jyiy50	Summary: The biggest threat to our democracy, freedom, and prosperity is a sycophant media that campaigns for one party and seeks to destroy the other. We are not a systemically racist country and it is absolutely not a threat to our democracy for anyone to challenge the results in an election.	Non-candidate
t3_jyb6wn	Exiled Tibetan leader Lobsang Sangay visits White House, irking China	Non-candidate
t3_jywq0m	U.K. to use AI tool to process 'high volume' of expected adverse reactions from COVID vaccine	Non-candidate
t3_jya6cm	Hungarian Prime Minister: 'Soros One of the Most Corrupt People in World'	Non-candidate
t3_jyqxuo	FLASHBACK: Experts Urge Clinton Campaign to Challenge Election Results in 3 Swing States (2016 claims of vote manipulation and hacking)	Non-candidate
t3_jz4so8	'Call of Duty: Black Ops Cold War' Affirms a Pro-American Worldview -- A rich gaming environment replete with Reagan administration cameos is just what the doctor ordered.	Non-candidate
t3_jyf6s6	Sidney Powell: Whistleblowers 'May Need Witness Protection' After Their Allegations Are Brought to Light	Non-candidate
t3_jyex3l	The Dems and Liberal Media Have Raised Issues with Dominion, Smartmatic, and ES&amp;S for 20 Years. The Left and media has Known About Chavez's Ties to Smartmatic since 2006. Here's the Stories That They Can't Unwrite	Non-candidate
t3_jyvsf7	Dutch doctors allowed to sedate euthanasia patients before their death	Non-candidate
t3_jz2m3h	The 1620 Project | NAS	Non-candidate
t3_jyjucr	The Greatest Electoral Heist in American History -- The pieces are finally coming together, and they reveal a masterpiece of electoral larceny involving Big Tech oligarchs, activists, and government officials who prioritize partisanship over patriotism.	Non-candidate
t3_jynyp2	Regeneron Gets Emergency Clearance for COVID-19 Therapy	Non-candidate
t3_jyt1et	Feds seek death penalty against gang leader accused of 7 murders	Non-candidate
t3_jz1a2k	TN Promise offers free college tuition. But high school seniors must apply now	Non-candidate
t3_jyv9rf	Black Rifle Coffee Founders Cave to the Rage Mob After Kyle Rittenhouse Wore Their T-Shirt, Pulls Blaze Sponsorship - Media Right News	Non-candidate
t3_jyt1jg	UN Hijacks #InternationalMensDay With Feminist ‚ÄúWokeness‚Äù	Non-candidate
t3_jyc9qd	CA-21 Republican David Valadao defeats Democrat Incumbent TJ Cox -- Reclaims another District stolen by ballot harvesting in 2018	Non-candidate
t3_jytbjn	Gov. Brown encourages Oregonians to call police on neighbors who violate COVID-19 freeze	Non-candidate
t3_jyr0yx	New York City Cop Pummeled By Mob, Police Say	Non-candidate
t3_jyv3rt	China Hero Guangcheng Chen Decries Brutal Forced Abortions, Infanticide	Non-candidate
t3_jymmtm	"If You Liked the 'New World Order,' You‚Äôll Love 'The Great Reset' -- Your betters think you need to be ""reset"" and Covid-19 has presented the ""opportunity."""	Non-candidate
t3_jymn5f	Pence Visits Georgia, Vows to ‚ÄòKeep Fighting Until Every Illegal Vote Is Thrown Out‚Äô	Non-candidate
t3_jywbu8	Howie Carr: Pam Kelley, another Kennedy casualty, passes away	Non-candidate
t3_jyhv8l	Drug overdose killed him, not my knee on his neck ‚Äì Officer in George Floyd‚Äôs death	Non-candidate
t3_jygcko	Tibetan political leader makes visit to White House for first time in six decades	Non-candidate
t3_jyly95	"Green Card Holder in Nevada Received Mail-In Ballot: ""The Japanese man who is a green card holder said that although he is not a U.S. citizen, he received a mail-in ballot. He was puzzled as to why he was registered as a voter by local authorities."""	Non-candidate
t3_jz1f69	Neighbors, businesses react to NE Portland vandalism	Non-candidate
t3_jyeymy	Dominion shuttering offices, shredding documents in dash to forestall post-election investigations	Non-candidate
t3_jyezy9	Sens. Warren, Klobuchar Sent Letter Warning About Dominion, Other Election Tech in 2019	Non-candidate
t3_jyvlgr	Xi Jinping‚Äôs Two Year Plan	Non-candidate
t3_jydomn	Gut check.	Non-candidate
t3_jyfgsz	"Jordan Sekulow: Pending Georgia Lawsuit 'Shocking' -- To those saying ""put up or shut up, it's coming this week."""	Non-candidate
t3_jyc4mm	In new twist, Georgia governor urges audit of ballot envelop signatures to look for fraud	Non-candidate
t3_jyi558	Federal Court Strikes Down Florida LGBTQ Counseling Ban -- Struck down laws that prohibit mental health professionals from counseling children and teens who are troubled by unwanted same-sex attractions or gender dysphoria.	Non-candidate
t3_jybxek	Gov. Cuomo wins Emmy for Best Portrayal of A Mass Murderer. ‚ÄúPeople around the world tuned in to find out what was going on and who Cuomo was going to kill next. It was really quite riveting‚Äù	Non-candidate
t3_jy4b5e	Ben Carson says he's 'out of the woods' after being 'extremely sick' with COVID-19	Non-candidate
t3_jymyck	Covid-19: Sweden's herd immunity strategy has failed, hospitals inundated	Non-candidate
t3_jyh39n	Sheriffs not enforcing Newsom's coronavirus curfew, won't 'make criminals' of law-abiding citizens	Non-candidate
t3_jyzmit	4 Radical Policies That Could Pass if Democrats Win the Georgia Senate Runoffs	Non-candidate
t3_jyh4ma	‚ÄòI Had To Protect Myself‚Äô: Rittenhouse Speaks Out Before Jail Release; New Details Emerge About Fatally Shot Rioter	Non-candidate
t3_jydelh	Giuliani Alleges Dominion Director's Ties to Antifa	Non-candidate
t3_jydeaa	Green Card Holder in Nevada Received Mail-In Ballot	Non-candidate
t3_jykval	The ACLU and College Professors are Encouraging Book Burnings	Non-candidate
t3_jylxwi	Tucker Carlson And Media Elites Cozy Up To Private Equity Moguls	Non-candidate
t3_jydz3d	Sen. Tom Cotton: It's the 400th anniversary of the Pilgrims' arrival. Why haven't we heard more about it?	Non-candidate
t3_jyq97y	Military flights up 500% last week	Non-candidate
t3_jyzux5	"(RNC) Chairwoman Ronna McDaniel: GOP Must 'Run Down Every Single Irregularity' -- ""From a party perspective, we need to run down every single irregularity and make sure we pursue it so it doesn't happen again, and see if it changes the course of this election."""	Non-candidate
t3_jype9s	Franklin Graham: 'Hatred that We See from Many in the Public Square Toward Christians Is Incredible'	Non-candidate
t3_jyp2at	The Swing Senator -- How Susan Collins survived the resistance.	Non-candidate
t3_jymtk9	Watch: Hundreds of Activists Gather for 'Stop the Steal' Rally in Georgia	Non-candidate
t3_jyjnpv	Jordan Sekulow to Newsmax TV: Pending Georgia Lawsuit 'Shocking'	Non-candidate
t3_jyp5t5	Struggling Retailers Owe $52 Billion In Overdue Rents (Lockdown effect?)	Non-candidate
t3_jyi398	Stacey Abrams‚Äô Group Dropping $2.7 Million Ahead of Georgia Senate Runoffs	Non-candidate
t3_jyp51o	Virginia Police Officers Deliver Thanksgiving Feasts Donated by Anonymous Family	Non-candidate
t3_jyaxu6	Scalise: GOP Gave Moderate Dems Chance to Vote with Us for the Last 2 Years; They Voted with Pelosi, AOC 90% of the Time	Non-candidate
t3_jyhleq	Media and Democrats Decide They Love Forever War Now Because Orange Man Bad	Non-candidate
t3_jya8e5	Carlson: 'Great News' if Powell Proves Tech Companies Switched Millions of Votes -- Uncovered 'Greatest Crime in the History of This Country'	Non-candidate
t3_jy8o93	Our hypocritical leaders refuse to obey their own COVID-19 rules. Actually, all the COVID rules are for us, not them. And the message that comes through loud and clear: Wink, wink ‚Äî COVID‚Äôs not really that big a deal.	Non-candidate
t3_jykrdw	Lying pizza joint employee forced 1.7 million people into COVID-19 lockdown	Non-candidate
t3_jymo4e	100+ Antifa Rioters Vandalized Portland Buildings -- No Arrests	Non-candidate
t3_jy8rml	81-year-old former Marine uses his grandfather's Irish shillelagh to beat down burglars and drive them away	Non-candidate
t3_jykueb	More New Research Shows Only Those With Symptoms Spread COVID-19. Masks, School Closings &amp; Lockdowns Couldn't Have Been More Pointless.	Non-candidate
t3_jyuk4i	Religion, Liberty, and Religious Liberty -- Emmanuel Macron Pushes France to Confront Islamism	Non-candidate
t3_jyjneg	Michigan, National Republicans Want State Certification Delayed	Non-candidate
t3_jyi40z	Outside Groups Flooding Georgia with Ad Buys Before Senate Runoffs	Non-candidate
t3_jyadln	Did You Know: Majority Of State Capitols Will Have Nativity Scene Displays In 2020; More To Come	Non-candidate
t3_jygjwb	Dems launch personal attacks against Wayne County GOP canvassers | One America News Network	Non-candidate
t3_jykfne	Bureau of Justice Statistics (BJS) - Violent Victimization by Race or Ethnicity, 2005-2019	Non-candidate
t3_jypbms	Delingpole: Sesame Street Sells Its Soul to the Great Reset	Non-candidate
t3_jyme81	James Freeman: Is there a vaccine to prevent media fright?	Non-candidate
t3_jxzwnd	Every County Sheriff in L.A. Region Declines to Enforce Gavin Newsom's Coronavirus Curfew	Non-candidate
t3_jybm40	Appeals court upholds 'reason bans,' denying abortions over Down Syndrome, gender or race	Non-candidate
t3_jyheq5	Jonathan Turley weighs in on Michigan AG's threats against Republicans who oppose certification	Non-candidate
t3_jye9se	Smartmatic email addresses show up in hacking groups for malware (makers of Dominion voting software) The Hackingteam Archives	Non-candidate
t3_jymbfx	The DNC Is Convinced Ossoff Is the Candidate That Can Flip the Senate	Non-candidate
t3_jz2vxd	A Hilarious Peaceful Protest Meme Shows the Truth about Antifa	Non-candidate
t3_jyazd0	The student loan crisis solved. Simple solutions are the best.	Non-candidate
t3_jymbg4	Gov. Newsom's Running Into a Problem with His COVID Curfew	Non-candidate
t3_jxvfcc	'We Must Cancel Thanksgiving,' Says CDC Scientist Who Looks Suspiciously Like A Turkey In A Lab Coat	Non-candidate
t3_jy0jq8	"Pro-Life Students Arrested For ""Black Preborn Lives Matter"" Chalking... Now They're Suing The City"	Non-candidate
t3_jymjav	Far-left San Francisco DA blasts Kyle Rittenhouse posting bail: 'White shooter motivated by racial bias'	Non-candidate
t3_jyik3v	Sidney Powell has expanded on the scope of the Dominion scam	Non-candidate
t3_jydaz1	If the Orange Man really wanted to be as BAD as you think he is.	Non-candidate
t3_jy4ptr	Georgia Governor Calls for Audit of Signatures on Ballot Envelopes	Non-candidate
t3_jyjtlr	When the NFL Plays Politics, Small-Business Owners Get Tackled, Too	Non-candidate
t3_jyofwf	George Floyd exhibit now open at Florida Holocaust center	Non-candidate
t3_jytvwo	Huntington Beach protest targets California‚Äôs coronavirus curfew	Non-candidate
t3_jydeux	Loeffler Calls for Bipartisan Group to Examine Georgia Mail-in Ballots	Non-candidate
t3_jy46nb	Liberals lash out at former child star Ricky Schroder after he helps bail Kyle Rittenhouse out of jail	Non-candidate
t3_jy13sv	Pennsylvania house orders election audit	Non-candidate
t3_jy4wx9	2020 Recount Ordered In Wisconsin	Non-candidate
t3_jy2cli	Close to 100,000 Ballots in Pennsylvania Flagged by Math Professor in Sworn Affidavit	Non-candidate
t3_jymats	Janet Daley: The infantilising of the (UK?) population over Covid is both medieval and immoral	Non-candidate
t3_jy6b5w	Congresswoman-elect starting 'Freedom Force' as counterweight to Dems' 'Squad'	Non-candidate
t3_jyfsno	Mich. back in play as Wayne County GOP canvassers rescind certifications | One America News Network	Non-candidate
t3_jyiisi	Green Card Holder in Nevada Received Mail-In Ballot	Non-candidate
t3_jyb2fr	IRONY ALERT: Newsom‚Äôs Restrictions Include Swanky Restaurant that Hosted His Infamous Dinner Party | Sean Hannity	Non-candidate
t3_jybjtt	If lockdowns work, why are they emptying the prisons?	Non-candidate
t3_jy2qnh	Kyle Rittenhouse Says He Purchased AR-15 with COVID Stimulus Check	Non-candidate
t3_jya5xb	Michigan GOP: We Are Putting the Secretary of State on Notice	Non-candidate
t3_jxtfum	Thanksgiving is November 26. Are you ready?	Non-candidate
t3_jyd2bv	A rude awakening coming to Europe	Non-candidate
t3_jy2yn9	Georgia Voting Meltdown in June Involved Dominion Voting machines	Non-candidate
t3_jy1vb6	Satire: Democrats Push To Keep Schools Closed So Kids Will Be Dumb Enough To Accept Socialism	Non-candidate
t3_jydirx	An Incredibly Relevant Winston Churchill Quote about Enemies	Non-candidate
t3_jy2yor	Multiple California Sheriffs Say They Will Not Enforce Gov. Newsom's New COVID Restrictions	Non-candidate
t3_jxx5ob	Republican Ex-Rep. Tenney Wins Back Her Seat by 106 Votes in Nail-Biting NY-22 Race	Non-candidate
t3_jxs99k	Black Female Police Chief in Virginia Fired After Aggressively Investigating and Prosecuting BLM Mob Violence	Non-candidate
t3_jxzytc	Dominion Voting Systems Backs Out of Hearing, 'Lawyers Up,' PA GOP Furious, 'Why Are They Hiding?'	Non-candidate
t3_jygbbr	Hard-to-find 2020 election fraud stories and links	Non-candidate
t3_jyfian	Dutch Doctors Can Now Drug Dementia Patients Before Killing Them to Prevent Resistance	Non-candidate
t3_jy4qhv	Data Scientist Flags Around 90,000 Votes in Pennsylvania	Non-candidate
t3_jypjqn	No More Lockdown - Van Morrison	Non-candidate
t3_jxrjrm	Dominion systems refuses to show up to Pennsylvania hearings	Non-candidate
t3_jy0gpq	Racist Left-Wing Video Violates Facebook‚Äôs 'Hate Speech' Guidelines, Remains Uncensored	Non-candidate
t3_jydflq	Midnight Train to Georgia? -- It is hardly surprising that progressive standard bearers are urging their fellows to winter in Georgia, register, and vote‚Äîbefore presumably decamping on January 6 to tell their friends of their heroic deeds.	Non-candidate
t3_jydl7u	7 Ways the 2005 Carter-Baker Report Could Have Averted Problems With 2020 Election	Non-candidate
t3_jydd2e	White House: Some states have ‚ÄòOrwellian‚Äô COVID-19 restrictions | One America News Network	Non-candidate
t3_jz3gu9	Any States Thinking About Certifying The Election Should RE-THINK...They Will Be Certifying Their Own FRAUD	Non-candidate
t3_jyqk89	[CDC] Trends in County-Level COVID-19 Incidence in Counties With and Without a Mask Mandate ‚Äî Kansas, June 1‚ÄìAugust 23, 2020	Non-candidate
t3_jy3nl0	Attorney Lin Wood: Georgia Woman Witnesses Shredding Company Shredding Ballots and Recycling Company Destroying Evidence at Elections Office in Cobb County	Non-candidate
t3_jxxqtz	Kyle Rittenhouse released from custody on $2 million cash bond	Non-candidate
t3_jz13ya	How Democrats plan to use Facebook and Twitter to subvert the first amendment and censor their critics	Non-candidate
t3_jy4r1n	Georgia Governor Calls for Audit of Signatures on Ballot Envelopes	Non-candidate
t3_jy41hq	Sidney Powell: Evidence of vote-fraud 'conspiracy' to be published -- Documents will be posted online as soon as this weekend	Non-candidate
t3_jxt0dz	Newsom Announces Curfew So He Won't Have To Wait In Long Line At Fancy Restaurants	Non-candidate
t3_jxqx1x	GOP Win In PA: Judge Tosses Thousands Of Ballots Without Dates, Reversing Lower Court Ruling	Non-candidate
t3_jy7mra	Conservative SCOTUS Justices Assigned to 4 of 6 Contested Election States	Non-candidate
t3_jxzwbe	Nikki Haley Asks AOC How Will She Pay for Green New Deal When She Wants to Pay People Not to Work	Non-candidate
t3_jy9z5t	What's Now at Stake Is The Rule of Law	Non-candidate
t3_jy8lyb	Should Conservatives Be Reeducated? Maybe So, According to a DNC Official	Non-candidate
t3_jxwx2d	Why have over 100 Dominion employees deleted their profiles on LinkedIn? ‚Äì Headlines 360	Non-candidate
t3_jxog87	College deletes Instagram post spotlighting Republican student after fellow students complain conservatives are dangerous, want to kill black people	Non-candidate
t3_jybkhl	Court: Tennessee Can Enforce Down Syndrome Abortion Ban	Non-candidate
t3_jxzkim	Kevin McCarthy letter urges 23 House Dems to bypass Nancy Pelosi and deliver COVID-19 relief for America	Non-candidate
t3_jy8kkz	Colin Kaepernick goes full radical with call to free cop killer	Non-candidate
t3_jy8v1a	Oregon Business Owners: State Officials Know Lockdowns Do Not Slow the Spread of Coronavirus, But They're Doing Them Anyway.	Non-candidate
t3_jxw4a9	Ohio Just Shut Down Their Republican Governor ‚Äì House Passes Bill To Keep Him From Closing Non-Essential Businesses	Non-candidate
t3_jxqjdc	CNN Accuses Parler As 'Threat To Democracy' Amid Facebook, Twitter's Censorship, Political Bias	Non-candidate
t3_jy17rm	Horror in Chicago: Bullet hits 5-year-old boy in the head as he sat on the couch playing on an iPad.	Non-candidate
t3_jy45yn	Sidney Powell's recent interview with Howie Carr...rather DISTURBING news if there is evidence. You should listen.	Non-candidate
t3_jyfh7c	Sorry, 1619 Project, But the Mayflower Was Far More Pivotal to American History	Non-candidate
t3_jy29fl	No Tucker, That's Not How This Works -- Simply put Mr. Carlson, demanding someone come on your show or else you‚Äôre writing them off is how the left operates.	Non-candidate
t3_jz07j1	Satire: Joseph Stalin To Receive International Emmy For His Outstanding Hunger Relief Efforts	Non-candidate
t3_jymbh7	Juliet Samuel: The real coronavirus scandal is not corruption. It's shocking state failure	Non-candidate
t3_jxy1at	WISN | Kyle Rittenhouse released from Kenosha County Jail	Non-candidate
t3_jxoif7	Tucker Carlson: Time for Sidney Powell to show us her evidence	Non-candidate
t3_jxqzln	Hungary Proposes Amendment to Protect Children's Biological 'Sex' and 'Christian' Upbringing	Non-candidate
t3_jxzgec	Dominion Voting Systems ‚ÄòLawyers Up,‚Äô Abruptly Backs Out of PA State House Fact-Finding Hearing	Non-candidate
t3_jxs8yk	Some California Sheriffs Are Telling Gov. Newsom to Shove It on His New Lockdown Orders	Non-candidate
t3_jy300d	Supreme Court Reveals New Circuit Assignments for Justices ‚Äî What You Need to Know. Look who‚Äôs in charge of WI,MI,PA,and GA üòâüòâ	Non-candidate
t3_jy9w0g	No, State Legislatures May Not Reverse the Result of the Election. If state lawmakers wished to end or disregard popular elections, they would have to repeal current law. That would be unfathomable.	Non-candidate
t3_jy1y2q	Andrew Cuomo To Get An Emmy For Televised COVID-19 Briefings	Non-candidate
t3_jyaahm	The High Cost of Beijing's Demands for Uniformity -- Why is Beijing so hostile toward those looking to practice their faith according to their conscience?	Non-candidate
t3_jy5s18	Group bankrolled by George Soros and Michael Bloomberg pours hundreds of thousands of dollars into Georgia runoff elections	Non-candidate
t3_jxw35p	Sidney Powell: Will Prove Case 'Within Next Two Weeks' in Court	Non-candidate
t3_jy4wvg	Cancel student-loan debt? That‚Äôs making the working class subsidize the elite!	Non-candidate
t3_jyx3xw	Noted German Doctor of Alternative Medicine and Lockdown Critic Arrested By Merkel's Gestapo Live on YouTube Stream	Non-candidate
t3_jybzm8	Student Loan Losses Seen Costing U.S. More Than $400 Billion. Projected toxic debt approaches subprime-mortgage losses incurred by lenders during financial crisis	Non-candidate
t3_jxu6vq	Divided Pennsylvania House gives approval for audit of 2020 election	Non-candidate
t3_jyx97b	The Historical Record Shows America Was Founded Against Racism	Non-candidate
t3_jxpoun	Plans to disarm Portland State campus police on hold after too many quit	Non-candidate
t3_jxrcyk	Dominion voting software can permit staff to manually adjust ballot returns during counting process	Non-candidate
t3_jy7pu5	Nikki Haley shuts down Ocasio-Cortez over her solution to the pandemic, and she is not happy about it	Non-candidate
t3_jxzu8m	Kyle Rittenhouse Released from Jail on $2 Million Bond	Non-candidate
t3_jy52ux	Levin: 'The Quantity of Fraud Is Not the Test'	Non-candidate
t3_jy1p41	BREAKING: Kyle Rittenhouse Posts $2 Million Dollar Bail -- Big Tech Shut Down His Social Media Accounts With No Verdict In Sight	Non-candidate
t3_jy9koe	Sen. Dianne Feinstein Seen Maskless in Public	Non-candidate
t3_jyzuxq	Chris Christie: Trump‚Äôs Legal Team Has Been a ‚ÄòNational Embarrassment‚Äô	O
t3_jyzq16	Putin Says He‚Äôs Not Ready to Recognize Biden as U.S. President	FR
t3_jyzpvt	"""How Trump Responded When Liz Cheney Called on Him to Concede: """"Sorry Liz, can‚Äôt accept the results of an election with hundreds of thousands of fraudulent votes cast, enough to easily flip the Election. You‚Äôre just unhappy that I‚Äôm bringing the troops back home where they belong!"""""""	SE
t3_jyvpw5	BREAKING: FDA Grants Emergency Use Authorization To Antibody Cocktail Used By Trump	O
t3_jyxl1z	How to explain Latino support for Trump? ABC News reports misleading memes went viral in Latino communities	O
t3_jz2tha	Trump obsession: Democrats tweet about him 12,569 times to 486 about Biden	O
t3_jywg7k	Devout Catholic Joe Biden, our most pro-abortion president	GI
t3_jyymh1	Reap What You Sow: Media Who Coddled Biden for Months Now Complain About Mistreatment	O
t3_jylbj0	CNN Condemns Trump Rallies As 'Physically Peaceful But Morally Violent'	O
t3_jyulqn	Trump Team Files for Fresh Recount in Georgia‚Äôs Presidential Race	GR
t3_jyunuj	"""Trump campaign adviser Steve Cortes: Sudden Stop In Mail-In Vote Count 'Suspicious' -- Particularly since it was followed by a """"deluge"""" of votes for Joe Biden in key battleground states."""	SE
t3_jyz99e	Trump Lawyer Sidney Powell Promises 'Biblical' Lawsuit in Coming Days	SE
t3_jywdz5	Philly Bans All Indoor Gatherings Unless You're Still Counting Biden Votes	O
t3_jyjte3	Ilhan Omar Urges Biden to ‚ÄòReverse‚Äô President Trump‚Äôs Middle East Agreements -- Thinks that peace between Israel and Arab nations is a bad thing.	GR
t3_jyl85p	Judge Dismisses Trump Campaign Suit to Invalidate PA Election Certification With Prejudice	SE
t3_jyxyyy	China Issues Instructions for ‚ÄòIncoming Biden Administration‚Äô	FR
t3_jyqh97	Chinese Warn Against Communism at Trump Rally, Tell Americans to Speak Out	FR
t3_jylfat	Hispanic Voters In Florida Who Fled Dictatorships Think The Election Was Stolen From Trump	SE
t3_jz37gc	Trump Derangement Syndrome in Democrats won't go away with Trump	O
t3_jz3j9r	BLM Founders Demand Joe Biden Support A 'Roadmap' To Abolition Of Police, Prisons	GI
t3_jz447i	"""Omar Urges Biden To Reverse Trump's Agreements In The Middle East And Claims They Were """"Not Peace Deals"""""""	FR
t3_jyztx6	Do Trump Supporters Live in an Alternate Universe?	O
t3_jyp5q9	Actor Scott Baio threatens to move to Utah to unseat Sen. Mitt Romney after his anti-Trump tweet	O
t3_jym9cn	Pennsylvania Judge Dismisses Trump Campaign's Challenge to Pennsylvania Election Law	SE
t3_jz3bhq	Pennsylvania election: Trump appeals dismissal of bid to block vote certification	SE
t3_jyusgt	Ben Carson: Trump Saved My Life After I Got COVID	O
t3_jz421o	It begins: The Biden border surge, and too bad about the COVID lockdowns	WA
t3_jykyw7	Federal Election Commission Chair: Trump Campaign Has Legitimate Claims of Election Fraud	SE
t3_jynp3x	Trump Orders Hasty Afghanistan, Iraq Drawdowns to Beat Biden Inauguration	FR
t3_jyuhux	Trump campaign attorney responds to Pennsylvania ruling &amp; they‚Äôre grateful	SE
t3_jymov0	Trump Warns 'Massive Fraud' to Be Uncovered in Michigan Vote	SE
t3_jyzt0i	Trump, as Always, Is Fighting, as Promised -- President Donald Trump is doing exactly what he promised his supporters he would do by fighting for every possible legal way to win the election.	SE
t3_jygwhl	Donald Trump Improved Standing With Latinos In 78 Of America‚Äôs 100 Majority-Hispanic Counties	GI
t3_jypb2u	Philly Bans All Indoor Gatherings Unless You're Still Counting Biden Votes	O
t3_jz1z44	Top House conservative plots post-Trump GOP	O
t3_jysta7	Trump camp's lawsuit struck down in Pennsylvania	SE
t3_jytpjk	Pa. Senator Pat Toomey Says President Trump Has 'Exhausted All Plausible Legal Options'	SE
t3_jyp7pw	Judge Dismisses Trump Campaign‚Äôs Pennsylvania Lawsuit, Slams ‚ÄòStrained‚Äô Reasoning; This only helps these cases reach higher levels of court because signed affidavits are admissible in court	SE
t3_jyby0o	Trump Announces Groundbreaking Rules to Lower Prescription Drug Prices	O
t3_jyr204	Trump campaign files for new recount in Georgia	GR
t3_jz0c9x	Satire: CNN Condemns Trump Rallies As 'Physically Peaceful But Morally Violent'	O
t3_jynua5	Release: Toomey Statement on PA Federal Court Decision, Congratulates President-elect Biden | U.S. Senator Pat Toomey of Pennsylvania	WA
t3_jyoy6m	Biden to ‚ÄòRacist‚Äô Trump Voters: ‚ÄòLet‚Äôs Heal.‚Äô That‚Äôs Easy for Him to Say.	O
t3_jypjqa	Merkel's Germany Tells Trump Not to Bring Troops Home from Afghanistan	FR
t3_jytan4	Detroit voters sue President Trump over his attempt to block certification of election results	SE
t3_jyqoj0	Dr. Ben Carson: Trump Saved My Life After I Got COVID	O
t3_jykt0d	Michigan AG Suggests Criminally Charging Republican Legislators for Meeting With Trump	O
t3_jyv0um	FDA Grants Emergency Use Authorization To Antibody Cocktail Used By Trump	O
t3_jyaufj	Berkeley professor sparks outrage by claiming Trump supporters who have an 'indifference' to COVID are like Germans who 'ignored and profited from the Holocaust'	O
t3_jyn4xj	Trump campaign statement on Pennsylvania ruling	SE
t3_jyobi4	Michigan Legislators Face Calls For Possible Criminal Charges After Meeting With President Trump On Certification	O
t3_jyp3ti	Trump Lawyers: Pennsylvania Lawsuit Dismissal Moves Us Closer to Supreme Court	SE
t3_jysprc	FDA Grants Emergency Use Authorization To Antibody Cocktail Used By Trump	O
t3_jyhhtr	McEnany: Trump's path to victory is Supreme Court, exposing 'systemic' voter fraud	SE
t3_jz1up7	Trump Lawyer Says New Lawsuits Will Be Filed in Georgia Soon: 'Quite a Shock'	GR
t3_jydj00	LIVE: March for Trump in Atlanta, Georgia	O
t3_jydzd2	Twitter says it will hand control of US president's official account to Joe Biden on January 20 - regardless of whether Donald Trump has left the White House	O
t3_jygs96	Merkel's Germany Tells Trump Not to Bring Troops Home from Afghanistan	FR
t3_jyfij4	Georgia Gov. Kemp Calls for Audit, Says Trump Can Demand New Recount	GR
t3_jy56dt	Trump Announces New Regulations Lowering Prescription Drug Costs	O
t3_jykdwj	Twitter Plans To Hand @POTUS Handle Over To Biden On Jan. 20 No Matter What	O
t3_jybrmo	Joe Biden's 'Vote Joe' website defaced by Turkish Hackers	O
t3_jyqipn	Time is just not on Trump‚Äôs side to overturn 2020 election results	SE
t3_jy9egu	Joe Biden loses it at reporter who asked about kids going back to classrooms - then tells press to leave	O
t3_jygoog	Trump voters back the President‚Äôs charges of election fraud led by Democrats	SE
t3_jy248u	Anti-Trump Legal Team Withdraws In Pennsylvania	O
t3_jy8qby	Joe Biden: Why Are Reporters Asking Me Questions? On Friday, Biden appeared dumbfounded as to why a reporter was asking the projected Democratic presidential-elect a question as the press pool was being scurried away by staff.	O
t3_jy4x55	Harvard Students Demand That Trump Officials Be Preemptively Barred From Campus	O
t3_jyhsxr	Brian Williams mocks Geraldo Rivera suggestion to name COVID-19 vaccine after Trump	O
t3_jybfam	BLM, Squad members pushing Dems, Biden to abolish prison	GI
t3_jy2icm	Donald Trump Jr. tests positive for COVID-19	O
t3_jyb4tl	6 Big Claims by Trump‚Äôs Lawyers About Overturning Election Results	SE
t3_jybaah	Rudy and Sidney‚Äôs Krakentastic Spectacle, and What It Could Mean -- A dismissive legacy media might have panned Team Trump‚Äôs press conference Thursday, but it was a significant moment with significant portents.	O
t3_jygabf	Ilhan Omar Urges Biden To ‚ÄòReverse‚Äô President Trump‚Äôs Middle East Agreements	FR
t3_jy1csd	Hispanic Voters in Florida Feel Election Was Stolen from Trump	SE
t3_jz1vvt	"""Patrick Buchanan: """"Is Trump Exiting Afghanistan -- to Attack Iran?"""""""	FR
t3_jxraf0	While You Were Focused on The Kraken, the Senate Continued Confirming Trump Federal Judges	O
t3_jy240e	How Christianity Gained Cultural Momentum In The Trump Era -- Some celebrities are not just talking the talk, but they seem to be walking a walk that seems to counter what Hollywood culture promotes and accepts.	O
t3_jy8kt6	Obama to produce Netflix series about Trump transition, unclear whether it will include abusing intel agencies to spy on successor	O
t3_jz0o5f	Trump: Biden would 'kill the American economy' in rejoining climate treaty.	WA
t3_jyc5wq	Bo Erickson of CBS asks Biden about his son. He says it's just a smear campaign.	FR
t3_jyfjr4	Trump Objects to Counting Thousands of Wisconsin Ballots	SE
t3_jxocbx	[Not Satire] National Democratic Party official suggests re-education for Trump supporters: 'How do you deprogram 75 million people?'	O
t3_jy6x6f	Whatever Happens In The Next Few Weeks, Brothers and Sisters, Remember This Clip, My Favorite 60 seconds of Trump: 'I am your voice'	O
t3_jy16dv	New Senate Report Confirms Hunter Biden's Biz ties to CCP, Raises Troubling Ties to Kremlin	FR
